111111121111111
111111111111111
111111111111111
222211111111111
111211112111111
111111112111111
111111112111111
111111112111111
111111112122111
112111112111222
112111111111111
112111111111111
111111111111111
111111112222222
111111111111111
111211111111111
111121111111111
111112111111111
111111211111111
111111111111111
